47
6
1 1 1 0 0 0 0 0 0 0 1 1 0 0 0 0 0 0 0 0 0 0 0 0 0 0 1 9 9 9 1 1 1 0 9 0 0 0 0 0 0 0 0 0 0 0 7   
1 1 1 0 0 9 0 9 0 1 1 1 0 0 1 0 0 0 0 0 0 0 1 0 9 0 0 0 0 0 1 1 1 0 0 9 0 0 0 0 0 1 0 1 1 1 1
1 1 1 0 0 0 1 0 0 1 1 1 0 0 0 0 9 0 0 0 9 0 0 0 0 0 0 0 0 0 1 1 1 0 0 0 9 0 0 0 1 0 0 1 1 1 1
1 1 1 0 0 0 1 0 0 1 1 1 0 0 0 0 0 0 1 0 0 0 0 0 0 0 0 0 0 0 1 1 1 0 0 0 0 9 0 1 0 0 0 1 1 1 1
1 1 1 0 0 0 1 0 0 1 1 1 0 0 0 0 0 0 0 0 0 0 0 0 0 0 0 0 0 0 1 1 1 0 0 0 0 0 0 0 0 0 0 1 1 1 1
1 1 1 9 9 9 1 9 9 1 1 1 9 9 9 9 9 9 9 9 9 9 9 9 9 9 9 9 9 9 1 1 1 9 9 9 9 9 9 9 9 9 9 1 1 1 1

1
2 -2 1 1 10